greg	PERSON
97.65	CARDINAL
64	DATE
28	CARDINAL
gilead	PERSON
chelsea	PERSON
miss.	GPE
1965	DATE
nevada	GPE
5,400	CARDINAL
18,000	CARDINAL
61	CARDINAL
fuji	ORG
ecuadorian	ORG
17.92	CARDINAL
poster	PERSON
jesuits	ORG
40	CARDINAL
alexa	GPE
larry	PERSON
pt	PERSON
beethoven	PERSON
doe	ORG
progress	ORG
nightly	DATE
longo	ORG
dillow	PERSON
economics	ORG
asean	ORG
presbyterian	ORG
tmobile	ORG
pgm	ORG
pierre	PERSON
wimbledon	ORG
vatican	ORG
brecht	PERSON
326	CARDINAL
1928	DATE
sung	PERSON
xinhua	ORG
states	GPE
640	CARDINAL
equitable	ORG
weiss	PERSON
aiw	ORG
differentiation	ORG
hefei	GPE
dana	ORG
skokie	GPE
seventeen	CARDINAL
brannigan	PERSON
hedi	PERSON
qatar	GPE
'99	DATE
jihad	ORG
osama	PERSON
major	PERSON
kramers	ORG
cpus	ORG
2020	DATE
turner	PERSON
loose	PERSON
skype	ORG
lexus	ORG
20s	DATE
medicaid	ORG
12.5	CARDINAL
initial	DATE
tony	PERSON
badgers	ORG
amway	ORG
right	ORG
the	CARDINAL
loudoun	ORG
pigalle	ORG
drexel	ORG
murata	ORG
research	ORG
s3	DATE
critical	DATE
wildly	ORG
decatur	GPE
1978	DATE
authoritarianism	ORG
fbi	ORG
bos	ORG
isetan	ORG
ike	PERSON
shao	ORG
manila	GPE
p.	PERSON
sports	ORG
comsat	ORG
eeoc	ORG
salman	ORG
lake	GPE
400	CARDINAL
holidays	DATE
pnb	ORG
northrop	ORG
brussels	GPE
verne	PERSON
ltv	ORG
platt	PERSON
ardmore	GPE
dracula	PERSON
revlon	ORG
4,900	CARDINAL
10.6	CARDINAL
twa	ORG
470,000	CARDINAL
venezuelans	ORG
fha	ORG
downey	PERSON
czechoslovakia	GPE
whitney	ORG
misunderstandings	PERSON
beverly	GPE
persians	ORG
control	ORG
mid	DATE
nagasaki	ORG
wealth	ORG
mosul	GPE
edemame	ORG
eu	ORG
matsuda	PERSON
bsb	ORG
howard	ORG
354,000	CARDINAL
mary	PERSON
3303	DATE
sisal	ORG
allah	PERSON
haagen	ORG
ten	CARDINAL
wlf	ORG
adn	ORG
baltimore	GPE
darpa	ORG
ramirez	PERSON
division	ORG
ponce	GPE
hurray	ORG
gates	PERSON
chip	PERSON
1862	DATE
202	CARDINAL
elders	ORG
giants	ORG
daiwa	ORG
vincennes	PERSON
8.	CARDINAL
egyptian	ORG
sonicare	ORG
richard	PERSON
months	DATE
delta	ORG
30,000	CARDINAL
presently	PERSON
springfield	GPE
coelho	PERSON
45,000	CARDINAL
wenzhou	GPE
irs	ORG
naples	GPE
warhol	PERSON
waite	PERSON
zimmerman	PERSON
bennett	PERSON
udn	ORG
nasa	ORG
sunkist	ORG
263	CARDINAL
173.1	CARDINAL
rlly	ORG
tupolev	ORG
120,000	CARDINAL
confucian	PERSON
conway	PERSON
1982	DATE
all	CARDINAL
991	CARDINAL
signal	ORG
reebok	ORG
cpg	ORG
elizabeth	PERSON
1987	DATE
taha	PERSON
ningbo	GPE
persia	GPE
ez	ORG
dow	ORG
brunei	GPE
0.13	CARDINAL
nato	ORG
dump	PERSON
full	DATE
bbc	ORG
epa	ORG
45	DATE
comp	GPE
1930	DATE
taiwan	GPE
finish	GPE
anchorage	GPE
22	CARDINAL
data	ORG
third	CARDINAL
badminton	ORG
idris	PERSON
7,300	CARDINAL
london	GPE
nhk	ORG
secord	PERSON
rubenstein	PERSON
pretoria	GPE
ein	ORG
calor	ORG
western	ORG
tr.	ORG
ccp	ORG
46,995	CARDINAL
ied	ORG
mahathir	PERSON
658	CARDINAL
sunnis	ORG
green	ORG
jack	PERSON
ducky	PERSON
chicago	GPE
managua	GPE
shamir	PERSON
cca	ORG
edward	ORG
936	CARDINAL
viera	ORG
5,200	CARDINAL
bunuel	ORG
flames	PERSON
22,000	CARDINAL
540	CARDINAL
220,000	CARDINAL
magazine	ORG
nicole	PERSON
aldergrove	PERSON
glenn	PERSON
conn	GPE
104	CARDINAL
344,000	CARDINAL
water	ORG
95.22	CARDINAL
2917	CARDINAL
u.k	GPE
fidelity	ORG
soap	ORG
chiang	PERSON
homeland	PERSON
1969	DATE
insight	ORG
rpgs	ORG
guggenheim	ORG
tod	ORG
takashimaya	ORG
sef	ORG
thousand	CARDINAL
1423	DATE
ontario	GPE
million	CARDINAL
gould	ORG
chappaqua	GPE
1.45	CARDINAL
curriculums	ORG
gitmo	ORG
mitch	PERSON
prophet	ORG
mid-1999	DATE
council	ORG
sherman	PERSON
email	ORG
rabin	PERSON
airbus	ORG
chechnya	GPE
ramos	PERSON
vietnam	GPE
judy	PERSON
aol	ORG
imperial	ORG
chavez	ORG
5,651	CARDINAL
olga	PERSON
tsui	GPE
constitutional	ORG
so	CARDINAL
linyi	ORG
beacon	GPE
labrador	GPE
250	CARDINAL
myanmar	GPE
fujian	GPE
336	CARDINAL
285	CARDINAL
ford	ORG
guantanamo	ORG
queens	GPE
450	CARDINAL
wong	PERSON
fernandez	PERSON
2001	DATE
abdullah	PERSON
bank	ORG
chad	GPE
vladimir	PERSON
scarsdale	GPE
gale	PERSON
145	CARDINAL
2023	CARDINAL
cray	ORG
namib	GPE
priceline.com	ORG
rma	ORG
170,000	CARDINAL
tivoli	GPE
sprite	ORG
hereafter	ORG
hsiao	PERSON
locals	PERSON
services	ORG
priceline	ORG
kamm	PERSON
16,000	CARDINAL
benelux	GPE
315	CARDINAL
oled	ORG
bethesda	GPE
rolodex	ORG
goncharov	PERSON
tianjin	GPE
leong	ORG
ely	PERSON
kennedy	ORG
270	CARDINAL
adams	PERSON
abidjan	GPE
pfp	ORG
pasadena	GPE
midlife	ORG
fonz	PERSON
vickers	ORG
portland	GPE
18th	DATE
khomeini	PERSON
korea	GPE
chevrolet	ORG
tallahassee	GPE
ginsburg	PERSON
kobayashi	PERSON
nader	PERSON
soros	ORG
1.9	CARDINAL
bakker	PERSON
cortese	PERSON
national	ORG
quincy	GPE
andes	GPE
1872	DATE
little	PERSON
wu	PERSON
2,580	CARDINAL
greenbelt	GPE
bremen	GPE
bmw	ORG
iceland	GPE
master	ORG
christ	PERSON
david	PERSON
11.88	CARDINAL
mei	GPE
nomura	ORG
lynchburg	GPE
less	CARDINAL
china	GPE
101.80	CARDINAL
dumont	ORG
munich	GPE
1.0	CARDINAL
1959	DATE
anaheim	GPE
ho	PERSON
cleveland	GPE
three-star	CARDINAL
campbell	PERSON
greenville	GPE
tannenbaum	PERSON
nanning	GPE
1968	DATE
weekdays	DATE
timbers	PERSON
kravis	PERSON
goliaths	PERSON
clarke	PERSON
standing	ORG
n.h.	GPE
dominica	ORG
wayne	GPE
623	CARDINAL
princeton	GPE
zia	PERSON
twenty	DATE
mehl	PERSON
safire	PERSON
acura	ORG
brouwer	PERSON
kach	PERSON
daytime	DATE
fair	ORG
lanzhou	ORG
applying	PERSON
lehman	PERSON
eric	PERSON
singing	PERSON
seasons	DATE
roy	PERSON
20	CARDINAL
20,000	CARDINAL
martha	PERSON
standardizing	ORG
1428	DATE
today	DATE
gm	ORG
teruel	ORG
1995	DATE
blum	PERSON
4th	DATE
baghdad	GPE
conn.	GPE
spring	GPE
teheran	GPE
ashland	ORG
1904	DATE
incredible	PERSON
lipton	ORG
lynn	GPE
mills	PERSON
bosnia	GPE
fascism	ORG
defense	ORG
pele	ORG
bethlehem	ORG
unr	ORG
kissinger	PERSON
jefferies	PERSON
tab	PERSON
weinstein	PERSON
bataille	ORG
77	DATE
jasmine	PERSON
dale	PERSON
tamim	ORG
wendy	ORG
quebec	GPE
157	CARDINAL
abs	ORG
mcdonalds	ORG
350	CARDINAL
newark	GPE
25000	CARDINAL
cbi	ORG
137	CARDINAL
hadassah	ORG
389	CARDINAL
81	CARDINAL
clubs	ORG
tonga	GPE
franklin	ORG
91	CARDINAL
aks	ORG
blair	PERSON
sukhoi	ORG
ming	PERSON
menopause	DATE
ayers	PERSON
gary	PERSON
camel	ORG
commission	ORG
abbie	PERSON
bonnie	PERSON
eddington	PERSON
joiner	PERSON
march	DATE
5,600	CARDINAL
ones	CARDINAL
sofia	GPE
1992	DATE
ross	PERSON
rubin	PERSON
norway	GPE
gui	PERSON
levin	PERSON
inverness	GPE
cincinnati	GPE
75	CARDINAL
carter	PERSON
karbala	GPE
burundi	GPE
yearly	DATE
canada	GPE
peugeot	ORG
railways	ORG
176	CARDINAL
sherwin	PERSON
ill.	GPE
eclecticism	ORG
brenda	PERSON
shu	ORG
burke	PERSON
cervantes	PERSON
island	GPE
720,000	CARDINAL
omar	PERSON
jockeyed	CARDINAL
kaplan	PERSON
23rd	DATE
soong	PERSON
nablus	GPE
hildebrandt	ORG
enron	ORG
sixth	CARDINAL
breeden	PERSON
austria	GPE
dominos	ORG
sahara	ORG
eni	ORG
panama	GPE
saleh	GPE
macon	GPE
fairfax	GPE
phillips	PERSON
katz	PERSON
geek	PERSON
mouth	PERSON
ethiopia	GPE
fox	ORG
coda	ORG
ehrlich	PERSON
fda	ORG
britan	PERSON
gingrich	PERSON
hi	ORG
92	CARDINAL
lewis	PERSON
dedham	GPE
1,800	CARDINAL
eds	ORG
2:1	CARDINAL
newport	GPE
osbourne	PERSON
chemical	ORG
hbo	ORG
foot	PERSON
wahabis	PERSON
mesopotamia	GPE
keating	PERSON
lamont	PERSON
1989	DATE
taichung	PERSON
wakefield	ORG
4,440	CARDINAL
nixon	PERSON
156	CARDINAL
hose	PERSON
189	CARDINAL
booker	PERSON
1963	DATE
owen	PERSON
barre	PERSON
wisconsin	GPE
rose	PERSON
bloomingdale	ORG
ingersoll	PERSON
bengal	ORG
palmeiro	ORG
zhen	ORG
jay	PERSON
minneapolis	GPE
honduras	GPE
catholic	ORG
hunt	PERSON
calligrapher	ORG
ryder	ORG
fresno	GPE
yan	PERSON
universal	GPE
7,800	CARDINAL
340	CARDINAL
1942	DATE
freedom	ORG
'96	CARDINAL
3,437	CARDINAL
wwii	ORG
kobe	ORG
popo	ORG
stabilizer	ORG
lavender	ORG
cross-over	CARDINAL
nathan	ORG
bunting	PERSON
29	CARDINAL
gowen	ORG
wedding	DATE
sprinkles	PERSON
lifetime	DATE
viacom	ORG
adsl	CARDINAL
pyongyang	GPE
500	CARDINAL
singapore	GPE
3,800	CARDINAL
4,348	CARDINAL
yung	CARDINAL
cortes	ORG
moscow	GPE
sanford	PERSON
namibia	GPE
union	ORG
espn	ORG
gop	ORG
salina	GPE
philadelphia	GPE
telegrams	PERSON
saddened	ORG
nepal	GPE
wada	PERSON
726	CARDINAL
us	GPE
betsy	PERSON
peasants	ORG
insights	ORG
salah	PERSON
alright	ORG
orlando	GPE
ad	ORG
johns	PERSON
american	ORG
assassins	ORG
lavelle	PERSON
tomlin	PERSON
250000	CARDINAL
venice	GPE
1974	DATE
unhcr	ORG
malibu	GPE
ohio	GPE
58.97	CARDINAL
otis	PERSON
knudson	PERSON
netanya	GPE
dictaphone	ORG
kosovo	GPE
foreign	ORG
prevention	ORG
harty	PERSON
mid-april	DATE
0.1	CARDINAL
lu	ORG
luzon	PERSON
dine	PERSON
shopping	ORG
taylor	ORG
eisenstein	ORG
100,000	CARDINAL
kentucky	GPE
denmark	GPE
section	ORG
2,064	CARDINAL
sprawl	PERSON
qatari	ORG
nowadays	PERSON
traub	PERSON
calif	GPE
d.c.	GPE
1971	DATE
80,000	CARDINAL
indonesia	GPE
exploration	ORG
kaiser	PERSON
taler	PERSON
2800	DATE
zoning	PERSON
johannesburg	GPE
guadalajara	GPE
specialized	ORG
changchun	GPE
fuzhou	GPE
samsung	ORG
forces	ORG
ken	PERSON
shopping.com	ORG
fischer	PERSON
u.s.	GPE
hall	PERSON
vanguard	ORG
boies	PERSON
skull	ORG
barber	PERSON
moe	ORG
workweek	DATE
rumsfeld	PERSON
shia	ORG
5k	CARDINAL
brigade	ORG
minor	ORG
commerzbank	ORG
anonymous	PERSON
vass	PERSON
99.80	CARDINAL
554	CARDINAL
rambo	PERSON
9.1	CARDINAL
hastings	PERSON
caterpillar	ORG
bart	ORG
2019	DATE
1957	DATE
egypt	GPE
greenberg	PERSON
titus	PERSON
hainan	GPE
guinea	GPE
board	ORG
havana	GPE
allen	PERSON
lee	PERSON
nasdaq	ORG
pennsylvania	GPE
kriz	PERSON
tmd	ORG
centcom	ORG
1912	DATE
budapest	GPE
gdr	GPE
zhuhai	PERSON
304	CARDINAL
july	DATE
cinderella	PERSON
flood	PERSON
olivetti	ORG
s.c	GPE
law	ORG
mobil	ORG
york	GPE
brits	ORG
jones	PERSON
hadith	ORG
kelly	PERSON
germany	GPE
norc	ORG
amex	ORG
schmidt	PERSON
vienna	GPE
taciturn	ORG
scraping	ORG
fanuc	ORG
322	CARDINAL
energy	ORG
sallah	PERSON
faa	ORG
eee	PERSON
margaret	PERSON
6000	CARDINAL
recruit	ORG
172	CARDINAL
anglo	ORG
henan	GPE
justin	PERSON
solidarity	ORG
penn	PERSON
minn.	GPE
ok	PERSON
rome	GPE
pornography	PERSON
norfolk	GPE
153	CARDINAL
end	ORG
pri	ORG
southside	GPE
d.c	GPE
1194	CARDINAL
eastern	ORG
chang	PERSON
kringle	PERSON
jingjing	PERSON
alexandria	GPE
dearborn	GPE
1,695,000	CARDINAL
riese	PERSON
eagle	ORG
ray	PERSON
tnt	ORG
proper	PERSON
goodson	ORG
sunni	ORG
hurley	PERSON
tanzania	GPE
atari	ORG
women	ORG
shams	PERSON
rut	GPE
consumers	ORG
damascus	GPE
451.6	CARDINAL
elder	PERSON
pound	PERSON
barak	PERSON
congress	ORG
rom	ORG
lodge	PERSON
schumer	PERSON
james	PERSON
daihatsu	ORG
bonn	GPE
sina.com	ORG
1927	DATE
aoun	PERSON
cabinet	ORG
207,000	CARDINAL
lin	ORG
textiles	ORG
honestly	PERSON
zagreb	GPE
information	ORG
clark	PERSON
170	CARDINAL
10.	DATE
garrison	PERSON
vichy	ORG
interface	ORG
dunno	PERSON
hesse	GPE
nikons	ORG
zulus	PERSON
cambodia	GPE
vancamp	PERSON
mubarak	PERSON
eurodisney	ORG
1958	DATE
coates	ORG
39,000	CARDINAL
uday	PERSON
yemen	GPE
3000	DATE
albright	PERSON
region	GPE
heyman	PERSON
chausson	PERSON
22.78	CARDINAL
solid	DATE
2/3	CARDINAL
lurie	PERSON
giffen	PERSON
thankfully	PERSON
doubleday	ORG
tsung	PERSON
dpp	ORG
hague	GPE
commerce	ORG
garfield	PERSON
vip	ORG
helsinki	GPE
via	ORG
auckland	GPE
riyadh	GPE
000	CARDINAL
lamore	PERSON
cohen	PERSON
yale	ORG
yangu	ORG
heller	PERSON
switzerland	GPE
least	CARDINAL
zionism	PERSON
sadam	ORG
la	ORG
michael	ORG
seasonally	DATE
niles	PERSON
washburn	PERSON
160	CARDINAL
1707	DATE
kyra	GPE
changsha	GPE
tcl	ORG
ismailis	ORG
2076	CARDINAL
murphy	PERSON
quinlan	PERSON
botticelli	ORG
spca	ORG
chongqing	GPE
uno	PERSON
panorama	ORG
consignments	ORG
champs	ORG
1956	DATE
ma'am	ORG
lalonde	PERSON
uli	ORG
miller	PERSON
buffalo	GPE
education	ORG
schering	ORG
uncle	GPE
uae	ORG
macintosh	ORG
boehm	PERSON
madagascar	ORG
135	CARDINAL
cctv	ORG
babbage	ORG
guardian	ORG
blodgett	PERSON
algiers	GPE
social	ORG
ogilvy	ORG
2	CARDINAL
success	ORG
bush	PERSON
lubbers	PERSON
lintas	ORG
276	CARDINAL
half	CARDINAL
bundy	PERSON
constellation	ORG
snow	PERSON
avs	ORG
jessica	PERSON
512	CARDINAL
giuliani	PERSON
broderick	PERSON
8	CARDINAL
wash.	GPE
rule	PERSON
nenad	PERSON
dornoch	GPE
nanchang	GPE
hackett	ORG
wollo	GPE
3/32	CARDINAL
2018	DATE
petroleum	ORG
thompson	PERSON
ninety	CARDINAL
glaser	PERSON
citicorp	ORG
barletta	PERSON
finland	GPE
like	CARDINAL
ralph	PERSON
braves	ORG
ron	PERSON
massachusetts	GPE
5,000	CARDINAL
swedish	ORG
pdas	ORG
nora	PERSON
5,100	CARDINAL
reggie	PERSON
barney	ORG
0000	DATE
nope	PERSON
maryland	GPE
morris	GPE
98	CARDINAL
agency	ORG
mccarthy	PERSON
hill	PERSON
canton	GPE
seuss	PERSON
ndl	ORG
putian	ORG
911	CARDINAL
871	CARDINAL
casey	PERSON
hogan	PERSON
1,700	CARDINAL
volokh	PERSON
twice	CARDINAL
optoelectronics	ORG
11,000	CARDINAL
kirkuk	ORG
grumman	ORG
cir	ORG
north	PERSON
ttv	ORG
falls	GPE
operations	ORG
gulf	ORG
lomotil	PERSON
99	CARDINAL
tan	PERSON
10.2	CARDINAL
basra	ORG
club	ORG
oecd	ORG
cordis	ORG
belize	ORG
537	CARDINAL
shrapnel	ORG
pepsi	ORG
quaker	ORG
quek	PERSON
fatima	GPE
wolf	PERSON
sharpe	PERSON
ntu	ORG
yoga	PERSON
sumitomo	ORG
courter	PERSON
299	CARDINAL
259	CARDINAL
lausanne	GPE
lancet	ORG
qin	ORG
nightdress	ORG
laden	PERSON
burns	PERSON
kurai	PERSON
krakow	GPE
smyrna	GPE
photonics	ORG
attractiveness	PERSON
liao	PERSON
alexander	PERSON
sharia	GPE
trappist	ORG
exposed	ORG
leventhal	PERSON
213	CARDINAL
thao	ORG
bavaria	GPE
lackey	PERSON
nashua	ORG
telecommunications	ORG
delaware	GPE
22,336	CARDINAL
uh	PERSON
684	CARDINAL
resources	ORG
waterford	ORG
94	CARDINAL
boeing	ORG
peterson	PERSON
books	ORG
mid-october	DATE
four	CARDINAL
salaam	PERSON
1809	DATE
zidane	ORG
bauman	PERSON
aoki	ORG
pizza	ORG
dixon	PERSON
muskegon	GPE
vandenberg	PERSON
asquith	PERSON
yangzhou	GPE
paris	GPE
fleischmann	PERSON
baptists	ORG
unisys	ORG
tmt	ORG
oneyear	DATE
orphaned	PERSON
lakeland	ORG
reagan	PERSON
1970	DATE
1988	DATE
oskar	ORG
9000	DATE
jupiter	PERSON
tandy	ORG
345	CARDINAL
trudeau	PERSON
basf	ORG
318	CARDINAL
729	CARDINAL
neverland	ORG
patriots	ORG
engler	PERSON
chesapeake	GPE
luck	PERSON
zimbabwe	GPE
brooks	PERSON
co-operative	ORG
fla.	GPE
nagoya	GPE
1960	DATE
490	CARDINAL
amis	ORG
suv	ORG
shenzhen	GPE
claire	PERSON
colgate	ORG
travelers	ORG
rumours	ORG
hicks	PERSON
avondale	ORG
leach	PERSON
afp	ORG
3,000	CARDINAL
amphibian	ORG
16	CARDINAL
president	ORG
2.	CARDINAL
arat	ORG
50	DATE
robinson	PERSON
sec	ORG
debra	GPE
milosevic	PERSON
npc	ORG
aldus	ORG
kursk	GPE
salomon	ORG
blessings	PERSON
andersson	PERSON
haig	GPE
legislature	ORG
ha	ORG
carmon	PERSON
450,000	CARDINAL
ual	ORG
byrne	PERSON
dod	ORG
yang	PERSON
00000	CARDINAL
1868	DATE
grand	ORG
koreas	ORG
kraft	ORG
enigma	ORG
warthog	ORG
red	ORG
vermont	GPE
carty	ORG
worldcom	PERSON
231	CARDINAL
mtv	ORG
7.	CARDINAL
jiangsu	GPE
kandahar	GPE
1400	DATE
sinfonia	ORG
3.8	CARDINAL
columbus	GPE
abc.com	ORG
pr	ORG
tbilisi	GPE
jinan	GPE
73	DATE
pravda	ORG
lily	PERSON
140	CARDINAL
thatcher	PERSON
1.4	CARDINAL
heart	ORG
kmart	ORG
simmons	PERSON
klass	PERSON
bernama	ORG
anwar	PERSON
anc	ORG
kellogg	ORG
944	CARDINAL
7,000	CARDINAL
miles	PERSON
sammy	PERSON
carefree	DATE
kenyans	ORG
1.78	CARDINAL
1937	DATE
90	CARDINAL
47	DATE
hu	PERSON
juilliard	ORG
fredrick	GPE
ind	GPE
hezbollah	ORG
70,000	CARDINAL
gabor	PERSON
savings	ORG
jewel	PERSON
tucson	GPE
hey	ORG
hiroshima	GPE
everyday	DATE
barclay	ORG
mint	ORG
778	CARDINAL
ahmad	PERSON
38	CARDINAL
formosa	ORG
vcu	ORG
temple	ORG
conservation	ORG
lipper	PERSON
brown	PERSON
simpson	PERSON
capital	GPE
kasi	ORG
ankara	GPE
reno	GPE
1,824	CARDINAL
islamic	ORG
lent	ORG
abcnews.com	ORG
1954	DATE
nickel	PERSON
10	CARDINAL
planar	ORG
safe	ORG
reds	ORG
543.5	CARDINAL
zionist	ORG
saatchi	ORG
32	CARDINAL
990	CARDINAL
woodside	GPE
riflemen	ORG
0.8	CARDINAL
group	ORG
likud	ORG
thanksgiving	DATE
briscoe	PERSON
vancouver	GPE
wen	PERSON
blunt	ORG
lsu	ORG
hindus	ORG
'98	CARDINAL
hughes	ORG
fed	ORG
katrina	ORG
ctv	ORG
trinity	ORG
indianapolis	GPE
heckman	ORG
forrest	PERSON
21	CARDINAL
3.13	CARDINAL
johnson	PERSON
141	CARDINAL
gre	ORG
rimbaud	PERSON
bechtel	ORG
bimonthly	DATE
hanoi	GPE
armenia	GPE
49	CARDINAL
quds	GPE
philippines	GPE
va.	GPE
palestinian	ORG
chuck	PERSON
honeybee	ORG
152.14	CARDINAL
frenchwoman	ORG
tsmc	ORG
martinez	PERSON
morgantown	PERSON
sunday	DATE
42	CARDINAL
couriers	PERSON
museum	ORG
wadi	ORG
un	ORG
tenth	CARDINAL
ghana	GPE
36,000	CARDINAL
pittsburgh	GPE
commonwealth	ORG
1855	DATE
aba	ORG
market	ORG
bayer	ORG
ag	ORG
will	PERSON
regiment	ORG
senior	ORG
seasonal	DATE
interviu	ORG
lagos	GPE
60s	DATE
oslo	GPE
smith	PERSON
cavalry	PERSON
ultrasonic	PERSON
semites	ORG
owens	PERSON
206	CARDINAL
1948	DATE
safra	PERSON
aetna	ORG
xerxes	GPE
patel	PERSON
amidst	ORG
6.84	CARDINAL
william	PERSON
howick	GPE
telecom	ORG
channel	ORG
sakhalin	ORG
plymouth	GPE
antichrist	ORG
achilles	PERSON
rtc	ORG
mecca	ORG
diana	PERSON
said	PERSON
nasser	PERSON
hitachi	ORG
miserly	CARDINAL
thursday	DATE
amgen	ORG
'97	CARDINAL
fame	ORG
2005	DATE
1,300,000	CARDINAL
semester	DATE
fs	ORG
arafat	PERSON
ge	ORG
53	CARDINAL
clinique	ORG
1,327	CARDINAL
dooling	PERSON
backhome	ORG
amazon.com	ORG
merciful	ORG
more	CARDINAL
pa.	GPE
111	CARDINAL
donations	PERSON
bowflex	ORG
120	CARDINAL
koo	ORG
240	CARDINAL
assembly	ORG
68	CARDINAL
burlington	ORG
41	CARDINAL
itn	ORG
elian	PERSON
kuomintang	PERSON
1997	DATE
93	DATE
troy	GPE
costco	ORG
shandong	GPE
metrorail	DATE
marietta	GPE
pec	ORG
five	CARDINAL
mattel	ORG
halle	GPE
825	CARDINAL
windsor	PERSON
bahamas	GPE
decades	DATE
warsaw	GPE
puli	ORG
ga.	GPE
u.s.c.	ORG
pusan	GPE
karen	PERSON
wmd	ORG
buchner	PERSON
canseco	PERSON
dorfman	PERSON
hingham	GPE
gracious	PERSON
a.m.	PERSON
intelligence	ORG
outlaws	ORG
hunan	GPE
wsn	ORG
694	CARDINAL
ochoa	PERSON
shultz	PERSON
kodak	ORG
940	CARDINAL
bushes	PERSON
1,320	CARDINAL
2,002	CARDINAL
gilmore	PERSON
melbourne	GPE
register	ORG
gpa	ORG
grohl	PERSON
britain	GPE
15.85	CARDINAL
220	CARDINAL
tdk	ORG
tisch	PERSON
glen	PERSON
deek	PERSON
great	GPE
usa	ORG
keller	PERSON
golden	ORG
00	DATE
official	ORG
zhengzhou	GPE
eleven	CARDINAL
congo	GPE
age	DATE
belgium	GPE
130	CARDINAL
kensington	GPE
mim	PERSON
mars	ORG
metro	ORG
andrea	PERSON
alan	PERSON
eritrea	GPE
cologne	GPE
teagan	PERSON
customs	ORG
chihuahua	ORG
casablanca	GPE
chen	PERSON
todt	PERSON
pre-1967	DATE
papers	ORG
2007	DATE
arizona	GPE
shop	ORG
rainier	PERSON
430,000	CARDINAL
solana	PERSON
luckily	ORG
jordan	PERSON
marine	ORG
26th	DATE
idaho	GPE
bejing	GPE
romania	GPE
attain	PERSON
businessnews	ORG
65,000	CARDINAL
amon	PERSON
indians	ORG
arthur	ORG
fortieth	ORG
33	DATE
inoue	ORG
guatemala	GPE
queen	ORG
hebron	GPE
gail	PERSON
economy	ORG
free	PERSON
bloomington	GPE
brody	PERSON
450000	CARDINAL
ocala	GPE
turkey	GPE
about	DATE
wednesday	DATE
philippe	PERSON
smithsonian	ORG
bonanza	ORG
madonna	PERSON
wells	PERSON
summer	DATE
hannibal	GPE
dammam	GPE
1998	DATE
east	GPE
guy	PERSON
1200	DATE
6,256	CARDINAL
pacific	ORG
67	CARDINAL
1,685	CARDINAL
shanghai	GPE
campaign	ORG
leon	PERSON
guillen	PERSON
from	DATE
148	CARDINAL
dulles	PERSON
ramallah	GPE
land	ORG
trenton	GPE
11.0	CARDINAL
a.d.	PERSON
popular	ORG
225	CARDINAL
184	CARDINAL
armonk	GPE
harvard	ORG
86	CARDINAL
fukuoka	ORG
fernandes	PERSON
serc	ORG
o'connell	PERSON
administration	ORG
ssms	ORG
amoco	ORG
shreveport	GPE
paul	PERSON
15.72	CARDINAL
harry	PERSON
natural	ORG
yeeesh	ORG
78	CARDINAL
lincoln	PERSON
riga	ORG
italy	GPE
1,224	CARDINAL
deltec	ORG
74	CARDINAL
300,000	CARDINAL
1999	DATE
gene	PERSON
coolmax	GPE
312	CARDINAL
14.06	CARDINAL
span	ORG
tuesdays	DATE
road	ORG
abc	ORG
cairo	GPE
highness	ORG
anti-israel	GPE
1,642	CARDINAL
18,136	CARDINAL
rinos	ORG
trade	ORG
rwanda	GPE
hunger	PERSON
3.69	CARDINAL
takken	PERSON
manchild	ORG
four-fold	CARDINAL
washington	GPE
2,412	CARDINAL
hamilton	GPE
bullock	PERSON
2,379	CARDINAL
nairobi	GPE
asahi	ORG
scalia	PERSON
time	ORG
11.	DATE
tsai	PERSON
evans	PERSON
kurzweil	ORG
jalalabad	GPE
1932	DATE
utah	GPE
oregon	GPE
rowland	ORG
pushkin	PERSON
hundreds	CARDINAL
ting	PERSON
chiriqui	GPE
haitian	ORG
dodge	ORG
garber	PERSON
tripoli	GPE
zdnet	ORG
fiji	GPE
smalling	PERSON
hence	PERSON
labonte	PERSON
yamaha	GPE
azis	PERSON
7.0	CARDINAL
anderson	PERSON
amman	GPE
hussein	PERSON
coors	ORG
murdoch	PERSON
angola	GPE
300	CARDINAL
as	CARDINAL
0.24	CARDINAL
jose	GPE
direct	ORG
satan	ORG
jaguar	ORG
solar	ORG
malta	GPE
georgia	GPE
cornell	PERSON
hui	GPE
loral	ORG
montana	GPE
1,892	CARDINAL
tobruk	GPE
surrealism	GPE
feingold	PERSON
marlin	PERSON
110	CARDINAL
sar	ORG
martin	PERSON
williamson	ORG
colonies	GPE
ying	PERSON
1244	DATE
wrights	ORG
kidder	ORG
tammy	PERSON
lufthansa	ORG
prc	ORG
christy	GPE
mickey	PERSON
ioc	ORG
sumita	PERSON
1.3	CARDINAL
mohammed	PERSON
ashcroft	PERSON
los	GPE
52	CARDINAL
christmas	DATE
allianz	ORG
chekhov	PERSON
tang	PERSON
life	ORG
1,859	CARDINAL
memphis	GPE
pope	PERSON
afghanistan	GPE
manchuria	PERSON
flad	ORG
now	DATE
sperry	ORG
communication	ORG
infantry	ORG
4756	DATE
mother	ORG
rupert	PERSON
1977	DATE
morning	ORG
safford	GPE
okla.	GPE
chiefs	ORG
sauls	PERSON
mvl	ORG
sanya	ORG
num	ORG
liza	PERSON
tonkin	PERSON
georgetown	GPE
44	CARDINAL
81,000	CARDINAL
quicktime	ORG
macmillan	ORG
ji	PERSON
evil	PERSON
forum	ORG
1960s	DATE
meatballs	GPE
224	CARDINAL
hammond	PERSON
chilly	DATE
qing	ORG
monday	DATE
collagen	ORG
grace	PERSON
cap	PERSON
late	DATE
forbes	ORG
contras	ORG
31	CARDINAL
mississippi	GPE
hidden	GPE
ussr	ORG
0.07	CARDINAL
noel	PERSON
kerry	PERSON
sao	GPE
prague	GPE
department	ORG
liz	PERSON
linguistic	ORG
israeli	DATE
80	CARDINAL
africa	GPE
edelman	PERSON
2189	DATE
olsen	PERSON
tesco	ORG
venture	ORG
macau	ORG
dmv	ORG
greenwich	GPE
shantou	ORG
zhang	PERSON
every	DATE
bobby	PERSON
gao	ORG
clintonville	GPE
weekends	DATE
westborough	GPE
00949	CARDINAL
35,000	CARDINAL
beirut	GPE
squamish	GPE
galapagos	ORG
ebay	ORG
brother	PERSON
nsc	ORG
roc	ORG
182,000	CARDINAL
vt	GPE
underground	PERSON
society	ORG
2010	DATE
fujimori	PERSON
chevron	ORG
fisher	PERSON
louisville	GPE
portugal	GPE
aso	PERSON
oman	GPE
chaste	PERSON
12,675	CARDINAL
143	CARDINAL
camden	GPE
zhou	PERSON
reed	ORG
17	CARDINAL
kiev	GPE
710.5	CARDINAL
oem	ORG
139	CARDINAL
wb	ORG
edison	ORG
1984	DATE
hamas	ORG
hud	ORG
silvers	PERSON
216	CARDINAL
23,000	CARDINAL
136	CARDINAL
missouri	GPE
mom	PERSON
chien	PERSON
dia	ORG
germanys	ORG
2003	DATE
beaverton	GPE
decade	DATE
billy	PERSON
later	DATE
kudos	PERSON
288	DATE
france	GPE
89.6	CARDINAL
florida	GPE
jepson	PERSON
54	CARDINAL
mpd	ORG
60	DATE
prudential	ORG
croatian	ORG
knoxville	GPE
carolyn	PERSON
hali	ORG
2.09	CARDINAL
beatrice	ORG
bala	GPE
13th	DATE
1/8	CARDINAL
pascal	PERSON
2,500	CARDINAL
yle	ORG
gorky	PERSON
saddam	PERSON
times	ORG
5320	DATE
cole	PERSON
cub	GPE
smu	ORG
cane	PERSON
bombay	GPE
ayer	ORG
patty	PERSON
etoys	ORG
manufacturing	ORG
warren	PERSON
1949	DATE
daley	PERSON
devil	ORG
md.	GPE
knight	PERSON
dispatch	PERSON
action	ORG
party	ORG
hatfield	PERSON
boje	PERSON
mp3	CARDINAL
shell	ORG
1990	DATE
davis	PERSON
rjr	ORG
dangerfield	PERSON
davos	GPE
2,000	CARDINAL
spotlight	ORG
caritas	ORG
lazio	PERSON
353	CARDINAL
4.6	CARDINAL
rejoice	ORG
soup	ORG
minwax	ORG
eisenberg	PERSON
11.38	CARDINAL
mo	GPE
elliot	PERSON
powhatan	ORG
1961	DATE
12,522	CARDINAL
geduld	PERSON
5000	DATE
bonds	ORG
cvs	ORG
8,355	CARDINAL
tass	ORG
2,809	CARDINAL
clearwater	GPE
brave	ORG
hundred	CARDINAL
p53	DATE
deborah	PERSON
hell	GPE
perry	PERSON
lion	ORG
aviators	PERSON
farming	DATE
desert	ORG
wellcome	ORG
kleinman	PERSON
1.7	CARDINAL
npr	ORG
sam	PERSON
austin	GPE
7	CARDINAL
merkur	ORG
roberts	PERSON
mandela	PERSON
2004	DATE
2012	DATE
jacqueline	PERSON
.....	ORG
20th	DATE
uzbekistan	GPE
tashkent	GPE
zarqawi	PERSON
parliament	ORG
1986	DATE
love	PERSON
astronomers	PERSON
55	CARDINAL
pell	PERSON
zoo	ORG
jpmorgan	ORG
geometry	PERSON
122	CARDINAL
thy	GPE
175	CARDINAL
eve	PERSON
redecorating	PERSON
hsbc	ORG
1940	DATE
mcconnell	ORG
n.j.	GPE
shaffer	PERSON
albany	GPE
sino	GPE
extracted	PERSON
regan	PERSON
fried	PERSON
montenegro	GPE
coming	DATE
chin	PERSON
churchill	PERSON
mansour	GPE
quito	GPE
shijiazhuang	GPE
kendrick	PERSON
ortega	PERSON
4/32	CARDINAL
azerbaijan	GPE
6.0	CARDINAL
matamoros	GPE
6	CARDINAL
buckles	PERSON
binghamton	GPE
hessians	ORG
faw	ORG
dad	PERSON
9.	CARDINAL
rahman	ORG
n.c.	GPE
pokemon	ORG
mid-july	DATE
weirton	ORG
entertaining	PERSON
fatah	ORG
trout	ORG
6.31	CARDINAL
rotarians	ORG
alexis	ORG
252.5	CARDINAL
jie	PERSON
2015	DATE
bnl	ORG
garman	PERSON
midi	GPE
tabah	ORG
jaleo	ORG
dr	ORG
10.5	CARDINAL
and	ORG
pakistan	GPE
two	CARDINAL
190	CARDINAL
armco	ORG
uaa	ORG
janna	PERSON
jilin	ORG
clara	GPE
dozens	CARDINAL
magi	ORG
mosaic	ORG
pontiac	ORG
eons	DATE
kyrgyzstan	ORG
800,000	CARDINAL
goat	ORG
slovakia	GPE
163	CARDINAL
rocco	PERSON
zhejiang	GPE
al	ORG
symposium	ORG
dali	PERSON
garn	PERSON
178	CARDINAL
environment	ORG
nfl	ORG
roth	PERSON
kashmir	GPE
robert	PERSON
hubei	GPE
475	CARDINAL
2014	DATE
bracknell	GPE
1953	DATE
ec	ORG
jiang	PERSON
105	CARDINAL
house	ORG
elections	ORG
macedonia	GPE
7.5	CARDINAL
dartmouth	ORG
schuman	PERSON
soho	ORG
saint	ORG
784	CARDINAL
tibe	ORG
0.5	CARDINAL
season	DATE
subaru	ORG
mid-1995	DATE
valerie	ORG
'07	DATE
suzhou	GPE
hardball	ORG
sia	ORG
parle	ORG
omaha	GPE
gym	ORG
kingston	GPE
progressive	ORG
watch	ORG
102	CARDINAL
high	ORG
1964	DATE
reuters	ORG
englewood	GPE
pons	PERSON
1980	DATE
t.	ORG
70	CARDINAL
fateh	ORG
gold	ORG
124	CARDINAL
1945	DATE
feds	GPE
900,000	CARDINAL
adrenaline	ORG
storer	ORG
150	CARDINAL
plame	ORG
jeb	PERSON
day	DATE
pbs	ORG
85	DATE
ottawa	GPE
couple	CARDINAL
liang	PERSON
vinci	PERSON
s.c.	GPE
shishi	ORG
catherine	PERSON
99.14	CARDINAL
pearl	ORG
bolton	PERSON
aron	ORG
37,820	CARDINAL
drake	ORG
handover	ORG
18,644	CARDINAL
dubai	GPE
146	CARDINAL
bangkok	GPE
supreme	ORG
lieber	PERSON
nova	ORG
brothers	ORG
macao	GPE
territory	GPE
a.p.	ORG
petersburg	GPE
sala	PERSON
webster	PERSON
emba	ORG
bell	PERSON
power	ORG
anhui	GPE
ladies	ORG
herzegovina	GPE
88	CARDINAL
miers	ORG
sportsmen	PERSON
ronald	PERSON
white	PERSON
photography	ORG
hr	ORG
tucker	PERSON
monthly	DATE
600	CARDINAL
tam	PERSON
toshiba	ORG
brea	GPE
url	ORG
8.0	CARDINAL
debussy	PERSON
mancuso	PERSON
interior	ORG
warner	ORG
enterprises	ORG
mcdonough	PERSON
cai	PERSON
tona	ORG
rove	PERSON
compact	PERSON
conceptualism	PERSON
charlotte	GPE
semiannual	DATE
nhtsa	ORG
morrisville	ORG
15,000	CARDINAL
sarasota	GPE
ali	PERSON
mpi	ORG
smirnoff	ORG
inc	ORG
599	CARDINAL
libya	GPE
august	DATE
aaa	ORG
compton	GPE
sydney	GPE
ed	PERSON
pensacola	GPE
cpa	ORG
cambridge	GPE
nih	ORG
manville	ORG
sarajevo	ORG
tu	PERSON
tropicana	ORG
morristown	GPE
naacp	ORG
holland	PERSON
whitten	PERSON
shary	ORG
joseph	PERSON
berlin	GPE
30-day	DATE
kao	ORG
hixson	PERSON
globalized	ORG
gillett	PERSON
1500	DATE
truth	ORG
edwards	PERSON
esseri	ORG
garcia	PERSON
deshi	GPE
ortiz	PERSON
uganda	GPE
qinghai	GPE
35670	CARDINAL
hartford	GPE
breaux	ORG
rand	ORG
mid-december	DATE
'94	CARDINAL
1943	DATE
mets	ORG
khatami	PERSON
eisenhower	PERSON
sanches	ORG
lorin	PERSON
17,500	CARDINAL
cuba	GPE
barbara	PERSON
412	CARDINAL
vinson	PERSON
tibet	GPE
ala	GPE
barnstorm	ORG
presidents	PERSON
msnbc	ORG
0.10	CARDINAL
u.k.	GPE
6.	CARDINAL
ukrainians	GPE
nelson	PERSON
ngos	ORG
1111	DATE
nike	ORG
juiced	PERSON
liverpool	GPE
nestle	ORG
isola	GPE
leesburg	PERSON
spain	GPE
virginia	GPE
united	ORG
mugabe	PERSON
westinghouse	ORG
650	CARDINAL
three	CARDINAL
qingdao	ORG
june	DATE
thunder	GPE
krishnamurthy	PERSON
larchmont	GPE
26	CARDINAL
lsx	ORG
cnn	ORG
1/3	CARDINAL
oldenburg	PERSON
tourism	ORG
roughly	CARDINAL
amiable	PERSON
strange	PERSON
uva	ORG
west	PERSON
hazel	PERSON
guangzhou	ORG
nigeria	GPE
garcias	PERSON
scotland	GPE
580	CARDINAL
hancock	PERSON
judaism	ORG
bp	ORG
duesseldorf	GPE
cargill	PERSON
dylan	ORG
sears	PERSON
xerox	ORG
ireland	GPE
freeport	GPE
429	CARDINAL
600,000	CARDINAL
5,791	CARDINAL
informix	ORG
99,000	CARDINAL
mcclelland	PERSON
nancy	PERSON
mci	ORG
34	CARDINAL
harker	PERSON
191	CARDINAL
islam	PERSON
5,500	CARDINAL
century	DATE
33.3	CARDINAL
hus	PERSON
polaroid	ORG
mcnair	PERSON
storms	PERSON
jazeera	GPE
phyllis	PERSON
1952	DATE
britains	ORG
era	DATE
ilan	GPE
cts	ORG
spiegel	ORG
1,900	CARDINAL
22nd	DATE
aclu	ORG
119.88	CARDINAL
cantonese	GPE
yeh	PERSON
cbs	ORG
capetown	GPE
faith	PERSON
braintree	GPE
annan	PERSON
lien	PERSON
health	ORG
annually	DATE
mid-september	DATE
fresenius	ORG
vdot	ORG
lichtenstein	GPE
wyo.	GPE
orr	PERSON
marsh	ORG
hoffman	PERSON
fisheries	ORG
150,000	CARDINAL
1925	DATE
orbis	ORG
maradona	PERSON
69	DATE
cie	ORG
week	DATE
yeltsin	PERSON
18	CARDINAL
405	CARDINAL
hiv	ORG
sochi	GPE
muhammad	ORG
netherlands	GPE
algeria	GPE
lansing	GPE
greenland	GPE
1800	CARDINAL
unilever	ORG
mindy	PERSON
marco	PERSON
gilo	ORG
kingdom	GPE
234	CARDINAL
1,000	CARDINAL
patsy	PERSON
waterbury	GPE
1975	DATE
oct	DATE
1,784	CARDINAL
renault	ORG
15th	DATE
tide	ORG
393	CARDINAL
maldives	GPE
kemp	PERSON
rosen	PERSON
internally	PERSON
119	CARDINAL
several	CARDINAL
clairol	ORG
9,000	CARDINAL
btw	ORG
56	DATE
89	CARDINAL
madame	ORG
mack	PERSON
koenig	PERSON
minna	PERSON
jobson	ORG
irishman	ORG
fong	GPE
r.i.	GPE
gu	PERSON
concord	ORG
,	GPE
lilith	ORG
aeroflot	ORG
chrysler	ORG
1905	DATE
eagan	ORG
su	PERSON
7.81	CARDINAL
cod	DATE
bundesbank	ORG
roh	PERSON
rdf	ORG
miami	GPE
durkin	PERSON
neb.	GPE
amy	PERSON
pioneer	ORG
djibouti	GPE
kimbrough	PERSON
jda	ORG
13	CARDINAL
287	CARDINAL
wapo	ORG
haines	PERSON
hassan	PERSON
quickview	ORG
da	PERSON
abby	PERSON
wright	PERSON
automation	ORG
tinseltown	GPE
76	CARDINAL
aaron	PERSON
wyoming	GPE
hizbullah	ORG
spaniard	ORG
cnbc	ORG
886	CARDINAL
410	CARDINAL
berkeley	GPE
rohs	PERSON
jan	DATE
cit	ORG
battle	PERSON
environmental	ORG
et	ORG
autumn	DATE
rodgers	PERSON
overseas	ORG
one	CARDINAL
264	CARDINAL
abrams	PERSON
nankang	GPE
dalian	GPE
caspar	GPE
fitness	ORG
ramadan	PERSON
marino	PERSON
denis	PERSON
7.1	CARDINAL
carrefour	ORG
re	ORG
greece	GPE
mikhail	PERSON
phoenix	GPE
md	GPE
kern	PERSON
tunas	GPE
han	PERSON
palace	ORG
yankees	ORG
6.9	CARDINAL
tsarist	ORG
708	CARDINAL
lady	PERSON
39	CARDINAL
gte	ORG
mossad	ORG
guam	PERSON
apollo	ORG
sally	PERSON
horwitz	PERSON
tharp	PERSON
dade	GPE
0.05	CARDINAL
um	PERSON
jeddah	GPE
chu	PERSON
northwest	ORG
central	ORG
7000	CARDINAL
re-entry	DATE
league	ORG
premiere	ORG
german	GPE
mujahideen	ORG
1962	DATE
leavitt	PERSON
september	DATE
valentine	PERSON
66	DATE
1600	DATE
chirac	PERSON
yaya	ORG
matra	ORG
tories	ORG
rifkin	PERSON
ewing	PERSON
albertville	GPE
cafferty	ORG
elasticity	ORG
wachovia	ORG
lithuania	ORG
matsushita	ORG
peninsula	GPE
26.23	CARDINAL
chevy	ORG
900	CARDINAL
hamburg	PERSON
phuket	GPE
hillsboro	GPE
sun	ORG
emperors	ORG
yahoo	PERSON
wuxi	ORG
566	CARDINAL
messenger	ORG
counties	GPE
dave	PERSON
3994	DATE
monsanto	ORG
modern	ORG
peres	PERSON
186	CARDINAL
maeda	ORG
nasd	ORG
1	CARDINAL
nasri	GPE
nickelodeon	ORG
flushed	ORG
tim	PERSON
virginians	PERSON
27	CARDINAL
tajikistan	GPE
er	PERSON
72	DATE
dublin	GPE
kaliningrad	ORG
mich.	GPE
venezuela	GPE
santa	GPE
flynn	PERSON
buzz	PERSON
intergraph	ORG
1991	DATE
basque	ORG
2009	DATE
jamie	PERSON
god	ORG
office	ORG
trumps	PERSON
cops	PERSON
wgbh	ORG
jiangxi	GPE
anne	PERSON
amtrak	ORG
goochland	GPE
zambia	ORG
security	ORG
regulations	ORG
variously	PERSON
ozzy	ORG
pva	ORG
wood	PERSON
breyer	PERSON
bogota	GPE
stirling	GPE
pop	ORG
2500	DATE
571	CARDINAL
liaoning	GPE
srinagar	ORG
rtp	ORG
px	ORG
3,372	CARDINAL
long	DATE
xu	PERSON
cav	ORG
roads	ORG
chile	GPE
custodian	ORG
1941	DATE
urban	ORG
core	ORG
25	CARDINAL
cht	ORG
24	DATE
fireman	PERSON
weekend	DATE
solomon	PERSON
hawaii	GPE
1.5	CARDINAL
pw	ORG
samuel	PERSON
scott	PERSON
stanford	ORG
shuang	GPE
2000	DATE
11	CARDINAL
sub-zero	CARDINAL
ko	PERSON
165	CARDINAL
journalist	ORG
searle	ORG
sharp	ORG
7777	DATE
southfield	GPE
groove	ORG
shanxi	GPE
northwestern	ORG
goldwater	PERSON
mik	ORG
kuwait	GPE
112.16	CARDINAL
vincent	PERSON
guizhou	GPE
recognition	ORG
shaanxi	GPE
1891	DATE
sudan	GPE
195	CARDINAL
800	CARDINAL
farmington	GPE
april	DATE
susan	PERSON
carolinas	GPE
fdic	ORG
boon	PERSON
mac	ORG
4500	DATE
103	CARDINAL
cohens	PERSON
589	CARDINAL
mbb	ORG
atlanta	GPE
nicaragua	GPE
kan.	GPE
b92	DATE
mercedes	ORG
flammable	PERSON
athletics	ORG
65	CARDINAL
1955	DATE
management	ORG
cloudy	PERSON
5,502	CARDINAL
construction	ORG
wsj	ORG
2,400	CARDINAL
bhuj	ORG
golo	PERSON
181	CARDINAL
days	DATE
n.j	GPE
district	ORG
far	CARDINAL
october	DATE
northern	GPE
planned	ORG
conte	PERSON
fiat	ORG
taoyuan	GPE
ebola	ORG
1,350	CARDINAL
129.48	CARDINAL
ibm	ORG
101.98	CARDINAL
lawrence	ORG
0.17	CARDINAL
monaco	GPE
mcduffie	PERSON
ai	PERSON
fellini	PERSON
dongguan	GPE
0.0002	CARDINAL
1980s	DATE
dobson	PERSON
nuremberg	GPE
earlier	DATE
souter	PERSON
federal	ORG
fifty	DATE
kim	PERSON
labor	ORG
prime	ORG
detroit	GPE
jeffrey	PERSON
commodities	ORG
sneak	PERSON
powell	PERSON
budget	ORG
rosenthal	PERSON
nantong	ORG
thriller	PERSON
knesset	ORG
parisian	ORG
academic	ORG
buddhism	ORG
greensboro	GPE
goliath	PERSON
halves	CARDINAL
31,777	CARDINAL
1/2	CARDINAL
middletown	GPE
walt	ORG
99.93	CARDINAL
northeast	ORG
maine	GPE
cdu	ORG
authority	ORG
1946	DATE
10/32	CARDINAL
dan	PERSON
levi	PERSON
ots	ORG
maybelline	ORG
buell	ORG
250,000	CARDINAL
denver	GPE
sogo	ORG
5.94	CARDINAL
wto	ORG
sahar	PERSON
iowa	GPE
abraham	PERSON
tv	ORG
1947	DATE
darwin	PERSON
gansu	GPE
535	CARDINAL
223	CARDINAL
michelle	PERSON
jerusalem	GPE
ukraine	GPE
harrisburg	GPE
neuilly	GPE
bengali	ORG
waggoner	PERSON
chan	PERSON
mike	PERSON
kristol	PERSON
xing	PERSON
inzer	PERSON
glorious	ORG
nashville	GPE
1,580	CARDINAL
hsia	CARDINAL
rain	PERSON
167	CARDINAL
jane	PERSON
zipper	PERSON
fixx	PERSON
slaughter	PERSON
lotus	ORG
lexington	GPE
2493	DATE
wcbs	ORG
chieftains	ORG
rural	ORG
baboo	GPE
staffing	ORG
peru	GPE
atlas	PERSON
mogadishu	GPE
fleet	ORG
beauregard	PERSON
174	CARDINAL
roman	PERSON
5.	CARDINAL
46	CARDINAL
nuggets	ORG
post	ORG
upjohn	ORG
1271	DATE
ala.	GPE
graf	PERSON
brooklyn	GPE
1062	DATE
ahmadinejad	ORG
amityville	GPE
bali	ORG
lockheed	ORG
clinton	PERSON
vanuatu	GPE
laos	GPE
569	CARDINAL
c.j.	ORG
belin	ORG
dassault	ORG
arab	ORG
hangzhou	GPE
ms.	ORG
radio	ORG
mallinckrodt	ORG
dennis	PERSON
iraqis	PERSON
clock	PERSON
bloodshed	PERSON
tampa	GPE
six	CARDINAL
soaked	ORG
nanjing	GPE
liu	PERSON
dreamer	ORG
regal	PERSON
kuwaitis	ORG
7th	DATE
lou	PERSON
gomel	GPE
assad	PERSON
moran	PERSON
wallop	PERSON
one-half	CARDINAL
naperville	GPE
jakarta	GPE
joyce	PERSON
chiu	PERSON
83	CARDINAL
embassy	ORG
li	PERSON
thirty	DATE
spendthrift	ORG
humvees	GPE
mandarin	ORG
zoeller	PERSON
misu	PERSON
284	CARDINAL
millennium	DATE
chiron	ORG
330	CARDINAL
occupation	ORG
kane	PERSON
2,936	CARDINAL
transparency	ORG
neutrality	ORG
avenue	ORG
bahraini	ORG
fedders	PERSON
knicks	ORG
21,153	CARDINAL
1,500	CARDINAL
abb	ORG
kaohsiung	PERSON
mrt	ORG
lhasa	GPE
1/4	CARDINAL
lauder	PERSON
sorrell	PERSON
u.n	ORG
predators	PERSON
bronx	GPE
1874	DATE
presidency	ORG
imf	ORG
14	CARDINAL
cheng	PERSON
tijuana	GPE
teddy	PERSON
indian	ORG
cheney	PERSON
134	CARDINAL
xinjiang	GPE
sting	ORG
goodday	ORG
teng	PERSON
india	GPE
milan	GPE
short	PERSON
nazism	PERSON
2,046	CARDINAL
roger	PERSON
fla	GPE
freudian	GPE
geraldo	PERSON
kgb	ORG
cadillac	ORG
138	CARDINAL
john	PERSON
summerland	GPE
beker	PERSON
lebanon	GPE
20237	CARDINAL
kazakhstan	GPE
1360	DATE
calgary	GPE
connecticut	GPE
bill	PERSON
mid-30s	DATE
sharon	PERSON
hitchcock	ORG
2,800	CARDINAL
contra	ORG
suez	ORG
transportation	ORG
gonzalez	PERSON
donaldson	ORG
levine	PERSON
amnesty	ORG
burma	ORG
mitsubishi	ORG
vfw	ORG
sixty	DATE
month	DATE
525	CARDINAL
geneva	GPE
tiger	ORG
hopeless	PERSON
3.	CARDINAL
eighty	CARDINAL
23	CARDINAL
309	CARDINAL
oscar	PERSON
ariel	PERSON
saudis	GPE
1909	DATE
256	CARDINAL
bmws	ORG
justice	ORG
russ	PERSON
waft	ORG
fridays	DATE
na	ORG
monica	GPE
dese	GPE
jammu	GPE
croatia	GPE
1,124	CARDINAL
holt	PERSON
mo.	GPE
denise	PERSON
sedatives	ORG
prospect	ORG
camille	PERSON
savior	PERSON
honda	ORG
1.19	CARDINAL
houses	ORG
jade	ORG
leahy	PERSON
conveniently	PERSON
8,000	CARDINAL
jericho	ORG
fighters	PERSON
nichols	PERSON
nintendo	ORG
traffic	ORG
shenyang	GPE
rci	ORG
texas	GPE
tiempo	ORG
calif.	GPE
zhu	PERSON
alas	PERSON
mass.	GPE
1929	DATE
standard	ORG
chichester	PERSON
amcap	ORG
tutu	PERSON
ups	ORG
poindexter	PERSON
1,400	CARDINAL
floridian	GPE
mcelroy	PERSON
londons	PERSON
62	CARDINAL
modesto	GPE
planning	ORG
hometown	PERSON
40,000	CARDINAL
petaluma	GPE
geotextiles	ORG
bangladeshis	PERSON
athens	GPE
michel	PERSON
wallis	ORG
kasparov	PERSON
wang	ORG
334,000	CARDINAL
morgan	PERSON
ziad	PERSON
6,165	CARDINAL
zaki	ORG
750	CARDINAL
coreys	ORG
kemper	ORG
leipzig	GPE
bot	ORG
malaysia	GPE
auspicious	DATE
tokyo	GPE
fitzwilliam	GPE
eta	ORG
35	DATE
housing	ORG
forrester	PERSON
volkswagen	ORG
counter-terrorism	ORG
thousands	CARDINAL
squibb	ORG
guinness	ORG
skb	ORG
mimi	PERSON
lsi	ORG
dvds	ORG
inouye	PERSON
science	ORG
daoist	ORG
mid-january	DATE
ldp	ORG
sosa	PERSON
ap	ORG
tech	ORG
kuo	PERSON
omb	ORG
court	ORG
deby	ORG
biennial	DATE
51	CARDINAL
renaissance	ORG
islamabad	GPE
oil	ORG
barcelona	GPE
dozen	CARDINAL
frank	PERSON
4,000	CARDINAL
laff	PERSON
woolworth	ORG
180	CARDINAL
michele	PERSON
stone	ORG
literacy	PERSON
catholicism	GPE
falk	ORG
truman	PERSON
tyler	PERSON
command	ORG
police	ORG
phil	PERSON
isi	ORG
opec	ORG
medina	ORG
sarah	PERSON
sony	ORG
mar	GPE
changzhou	ORG
captain	PERSON
slade	PERSON
thirds	CARDINAL
gerona	GPE
cunningham	PERSON
frankenstein	PERSON
dole	PERSON
moussa	PERSON
115	CARDINAL
kyocera	ORG
jacksonville	GPE
election	ORG
canal	ORG
simon	PERSON
alaska	GPE
citizens	ORG
438	CARDINAL
yuan	ORG
pinnacle	ORG
flexibility	PERSON
clintons	PERSON
1000	DATE
54,000	CARDINAL
apf	ORG
mass	GPE
fazio	PERSON
ma	ORG
wfp	ORG
somalia	GPE
marley	PERSON
humvee	PERSON
uso	ORG
marines	ORG
continental	ORG
exchange	ORG
fourth	CARDINAL
holiday	DATE
tufts	ORG
tiffany	ORG
nu	ORG
tseng	PERSON
17,000	CARDINAL
mca	ORG
baltics	ORG
700	CARDINAL
pows	ORG
state	ORG
mercifully	ORG
sars	ORG
illinois	GPE
iraq	GPE
typhus	ORG
ngo	ORG
dean	PERSON
manhattan	GPE
wash	GPE
intel	ORG
nutting	PERSON
soyuz	ORG
tolstoy	PERSON
mid-1991	DATE
219	CARDINAL
nba	ORG
lme	ORG
biannual	DATE
9,500	CARDINAL
airlines	ORG
duncan	PERSON
weekday	DATE
rice	PERSON
baglioni	ORG
smartnet	PERSON
168	CARDINAL
broward	GPE
menuhin	PERSON
montreal	GPE
fujin	PERSON
chips	PERSON
millions	CARDINAL
pat	PERSON
christopher	PERSON
428,000	CARDINAL
cia	ORG
providence	GPE
shang	PERSON
josephine	PERSON
ahmed	PERSON
nevis	ORG
rochester	GPE
7.8	CARDINAL
jurvetson	PERSON
gaddafi	PERSON
mexico	GPE
sixteen	DATE
916,000	CARDINAL
caracas	GPE
bbs	ORG
cic	ORG
taliban	PERSON
marks	ORG
dnc	ORG
citigroup	ORG
shirley	PERSON
mondays	DATE
ww	ORG
tribunal	ORG
bat	ORG
hib	ORG
mia	PERSON
hsieh	PERSON
kohl	PERSON
portals	ORG
jin	PERSON
200,000	CARDINAL
seagram	ORG
stockholm	GPE
79	DATE
kelli	PERSON
prisons	PERSON
sui	ORG
chao	PERSON
siamese	ORG
hiro	PERSON
1881	DATE
107	CARDINAL
1967	DATE
saab	ORG
cubs	ORG
cltv	ORG
february	DATE
anheuser	ORG
ptl	ORG
thailand	GPE
265	CARDINAL
fauquier	GPE
germ	PERSON
electron	ORG
directorate	ORG
4.	CARDINAL
hotline	ORG
ferris	PERSON
lockerbie	GPE
mirror	ORG
jeep	ORG
tien	ORG
tnn	ORG
sterling	GPE
229,000	CARDINAL
over-emphasize	CARDINAL
ou	PERSON
darwinism	PERSON
farc	ORG
skii	ORG
cdl	ORG
bishkek	GPE
o'brian	PERSON
brady	PERSON
goode	PERSON
konka	GPE
congratulating	PERSON
lynch	ORG
miranda	PERSON
zuni	PERSON
haikou	GPE
perth	GPE
virginian	GPE
haiti	GPE
369,000	CARDINAL
butterflies	PERSON
melanie	PERSON
eva	ORG
per	PERSON
tva	ORG
microsoft	ORG
lung	PERSON
mcv	ORG
ky.	GPE
fdr	ORG
ivanov	PERSON
smes	ORG
texaco	ORG
5,226	CARDINAL
midland	GPE
cetus	ORG
ridge	GPE
bulls	ORG
21,000	CARDINAL
albuquerque	GPE
departments	ORG
emeryville	GPE
tetris	ORG
ucla	ORG
chengdu	GPE
electric	ORG
36	CARDINAL
2,200	CARDINAL
variety	ORG
patrick	ORG
kaine	PERSON
consolidated	ORG
quantum	ORG
roche	ORG
balzac	PERSON
richardson	GPE
mort	PERSON
bradley	PERSON
snakes	ORG
del.	GPE
stewart	PERSON
stubhub	ORG
495,000	CARDINAL
bulgaria	GPE
steve	PERSON
fauvism	ORG
brierley	PERSON
gujarat	GPE
page	PERSON
emigrating	ORG
cupertino	GPE
whoville	GPE
132	CARDINAL
america	GPE
2008	DATE
kirin	ORG
tipper	PERSON
yunnan	GPE
faisal	PERSON
fos	PERSON
cretaceous	DATE
kalamazoo	GPE
hsu	PERSON
cheung	ORG
souris	GPE
2016	DATE
22,925	CARDINAL
kremlin	ORG
hir	ORG
boulder	GPE
n.c	GPE
werner	PERSON
noriega	PERSON
tomorrow	DATE
tw	ORG
kingsville	GPE
h.	ORG
101	CARDINAL
shih	ORG
gatorade	PERSON
55,000	CARDINAL
clever	ORG
mit	ORG
gatt	ORG
caliph	ORG
holy	ORG
holmes	PERSON
monmouth	GPE
cpc	ORG
fantome	ORG
martine	PERSON
252	CARDINAL
blackwell	PERSON
russia	GPE
kunshan	ORG
1.46	CARDINAL
paula	GPE
maoist	ORG
sheriff	PERSON
10,000	CARDINAL
guangdong	GPE
gmac	ORG
321	CARDINAL
04	CARDINAL
audi	ORG
republic	ORG
center	ORG
0.272	CARDINAL
wis.	GPE
0	CARDINAL
playboy	ORG
yesterday	DATE
fifteen	CARDINAL
univision	ORG
originally	PERSON
10th	CARDINAL
5.0	CARDINAL
zeta	ORG
luxembourg	GPE
brad	PERSON
winchester	GPE
178.8	CARDINAL
toronto	GPE
seattle	ORG
seven	CARDINAL
8th	DATE
slater	PERSON
sweden	GPE
2006	DATE
kathmandu	GPE
charles	PERSON
singaporeans	ORG
ouch	ORG
syracuse	GPE
weekly	DATE
waltham	GPE
1,250,000	CARDINAL
pentagon	ORG
zero	CARDINAL
merrill	ORG
joe	PERSON
301	CARDINAL
6th	DATE
rockefeller	ORG
suffolk	GPE
chichi	GPE
egyptians	ORG
thrashers	ORG
beijing	GPE
tennessee	GPE
canberra	GPE
550	CARDINAL
lewinsky	PERSON
dundalk	ORG
seaman	ORG
dj	ORG
ntt	ORG
eighth	CARDINAL
11.6	CARDINAL
5,883	CARDINAL
visa	ORG
bahrain	GPE
40.4	CARDINAL
winter	DATE
camerino	GPE
zt	ORG
rit	ORG
thirties	DATE
hungary	GPE
asmara	GPE
nearly	DATE
norma	PERSON
cwa	ORG
hillary	PERSON
november	DATE
aav	ORG
haditha	GPE
putin	PERSON
stoltz	PERSON
1990s	DATE
5/32	CARDINAL
sicily	GPE
pleasant	GPE
fallujah	GPE
dram	ORG
solace	PERSON
ironic	PERSON
131	CARDINAL
tarawa	ORG
villanova	ORG
diet	ORG
news	ORG
strasser	PERSON
treasury	ORG
u.n.	ORG
sox	ORG
linda	PERSON
chou	PERSON
2,600,000	CARDINAL
oklahoma	GPE
jurists	ORG
n.y	GPE
firestone	ORG
sincere	PERSON
cavaliers	ORG
irving	ORG
aggie	ORG
mid-week	DATE
1973	DATE
240,000	CARDINAL
pepper	ORG
exxon	ORG
nyc	ORG
ida	PERSON
hebei	GPE
laura	PERSON
greenspan	PERSON
boren	PERSON
diago	ORG
jds	ORG
birmingham	GPE
166	CARDINAL
karachi	GPE
hyundai	ORG
1.08	CARDINAL
lancaster	GPE
buick	ORG
uk	GPE
patterson	PERSON
6/2	CARDINAL
california	GPE
37	DATE
lombardo	PERSON
scottish	ORG
islamists	ORG
plo	ORG
sheraton	ORG
n.y.	GPE
kean	PERSON
lima	GPE
flores	PERSON
tunisia	GPE
eight	CARDINAL
cleopatra	PERSON
leno	ORG
mazen	ORG
listening	PERSON
predicament	PERSON
panetta	PERSON
moss	PERSON
'45	CARDINAL
1993	DATE
jackson	GPE
weihai	GPE
51.23	CARDINAL
hayden	PERSON
shannon	PERSON
nine	CARDINAL
tegucigalpa	GPE
gaza	GPE
army	ORG
jen	CARDINAL
staar	ORG
albo	PERSON
14,500	CARDINAL
jacobs	PERSON
development	ORG
2.88	CARDINAL
anniston	GPE
3,100	CARDINAL
11,586	CARDINAL
nt	GPE
fall	DATE
ariz.	GPE
december	DATE
milken	PERSON
30	CARDINAL
richmond	GPE
1970s	CARDINAL
tung	PERSON
19	CARDINAL
nakamura	PERSON
executive	ORG
specter	PERSON
arlington	GPE
wyo	GPE
1950s	DATE
craven	PERSON
peterborough	GPE
gbagbo	PERSON
460	CARDINAL
warners	ORG
lawson	PERSON
sheikha	ORG
phillies	ORG
abcs	ORG
okay	PERSON
buddhists	GPE
182	CARDINAL
merck	ORG
13,000	CARDINAL
judiciary	ORG
oprah	PERSON
around	CARDINAL
belgrade	GPE
ritz	ORG
twelve	CARDINAL
oppenheimer	ORG
lisbon	GPE
australia	GPE
hhs	ORG
gaf	ORG
foundation	ORG
4241	DATE
nowak	PERSON
medellin	GPE
elle	ORG
mitchell	PERSON
930	CARDINAL
pam	PERSON
celtic	GPE
negas	PERSON
cross-national	ORG
some	CARDINAL
pudong	ORG
hal	PERSON
branford	GPE
kwan	PERSON
jfk	ORG
200	CARDINAL
aspin	PERSON
96	CARDINAL
kiribati	GPE
303	CARDINAL
pu	PERSON
toyota	ORG
foley	PERSON
1951	DATE
bus	ORG
years	DATE
33,000	CARDINAL
packwood	PERSON
seoul	GPE
slovenia	GPE
ames	GPE
huntsville	GPE
lot	ORG
doof	PERSON
city	GPE
0.12	CARDINAL
crystal	ORG
first	ORG
raskolnikov	PERSON
monterrey	GPE
year	DATE
6,500,000	CARDINAL
572	CARDINAL
nynex	ORG
byrd	PERSON
apple	ORG
netanyahu	PERSON
pa	GPE
kan	GPE
falcon	ORG
chitchat	ORG
church	ORG
starbucks	ORG
fidel	PERSON
nui	GPE
minnesota	GPE
phelan	PERSON
mao	PERSON
1075	DATE
people	ORG
chaplin	PERSON
arkansas	GPE
fourteen	CARDINAL
jinjiang	GPE
atkins	PERSON
good-bye	PERSON
montvale	GPE
hutchinson	GPE
300-day	DATE
tarot	ORG
quarter	DATE
fema	ORG
ss	ORG
smile	GPE
lang	PERSON
ee	ORG
iso	ORG
blumenfeld	PERSON
wenz	PERSON
1908	DATE
kessler	PERSON
113	CARDINAL
jim	PERSON
nickie	PERSON
gb	ORG
shalu	GPE
serbia	GPE
prada	ORG
downing	PERSON
robertson	PERSON
ascend	PERSON
voa	ORG
1976	DATE
gazelle	ORG
1939	DATE
infiniti	ORG
cri	ORG
tom	PERSON
fedayeen	ORG
lloyd	PERSON
flying	ORG
quarters	DATE
a.	ORG
tch	ORG
n.m.	GPE
va	ORG
vitamin	DATE
thal	PERSON
draper	ORG
england	GPE
estonia	GPE
wfaa	ORG
delay	PERSON
heidegger	ORG
farmers	ORG
15	CARDINAL
mahatma	PERSON
picc	ORG
2,960	CARDINAL
see	ORG
nev.	GPE
de-escalate	GPE
baidu	ORG
2002	DATE
may	DATE
1,200	CARDINAL
feng	PERSON
ctb	ORG
112	CARDINAL
committee	ORG
mulroney	PERSON
58	DATE
cook	PERSON
chanel	ORG
aziz	PERSON
westin	ORG
1,474	CARDINAL
303.00	CARDINAL
mofa	ORG
publishers	ORG
disney	ORG
kkr	ORG
25,000	CARDINAL
fewer	CARDINAL
baker	PERSON
deng	PERSON
excellency	ORG
400,000	CARDINAL
gadhafi	PERSON
60,000	CARDINAL
435	CARDINAL
grandma	PERSON
interestingly	PERSON
preservation	PERSON
hypocrite	ORG
lesko	PERSON
ubs	ORG
politburo	ORG
harris	PERSON
piscataway	GPE
1985	DATE
bowen	ORG
nbc	ORG
jsp	ORG
mid-1990	DATE
yalta	GPE
4200	DATE
tenn.	GPE
rayburn	PERSON
1875	DATE
congressional	ORG
appel	PERSON
manion	PERSON
brookline	GPE
talal	PERSON
dalis	PERSON
dick	PERSON
liberty	ORG
alabama	GPE
centuries	DATE
mazda	ORG
4	CARDINAL
newsday	ORG
zeros	CARDINAL
ben	PERSON
nsb	ORG
weyerhaeuser	ORG
1.43	CARDINAL
metropolitan	ORG
winters	DATE
biden	PERSON
tannoy	PERSON
hummer	ORG
1926	DATE
ariz	GPE
37,860	CARDINAL
robins	ORG
louisiana	GPE
grover	PERSON
sarkozy	PERSON
1,400,000	CARDINAL
archaeopteryx	DATE
coke	ORG
bustling	CARDINAL
nov	DATE
u.s	GPE
kikkoman	ORG
chiapas	GPE
bruch	PERSON
capri	ORG
philips	ORG
ramstein	ORG
57	DATE
milwaukee	GPE
carey	PERSON
zionists	ORG
saud	PERSON
nikko	ORG
